11111111111111111111111111
1P111111111111111111111E11
10111111111111111111111011
10000000000000000000000011
11011101110101011110101011
11000100010001010010101011
11010101110011011010101011
10000100010101000010100011
10011111111111111111111011
1C111111111111111111111C11
11111111111111111111111111