1111111111
101C001001
1000101001
1010P01101
1001000001
1010011101
1001B00101
10011001E1
10C0000001
1111111111