11111111111111111111111
100000000000000C00000C1
10C000E1001000001010011
10111100101010100010011
1P1001000C00C0000000001
101001000000C00C00000C1
101001000000000C00000C1
11111111111111111111111